3 2 2 2 2 2 2 2 2 2 2 2 2 2 2 2 2 2 2 2 2 2 4
1 15 0 0 0 0 0 0 0 0 0 0 0 0 0 0 0 0 0 0 0 15 1
1 0 3 13 4 0 3 2 2 2 2 13 2 2 2 2 4 0 3 13 4 0 1
1 0 1 16 1 0 14 7 0 7 0 7 0 7 0 7 14 0 1 16 1 0 1
1 0 5 13 6 0 5 2 2 2 2 2 2 2 2 2 6 0 5 13 6 0 1
1 0 0 0 0 15 0 0 0 0 0 0 0 0 0 0 0 15 0 0 0 0 1
1 0 3 13 2 2 4 0 3 2 2 9 2 2 4 0 3 2 2 13 4 0 1
1 0 1 7 0 7 1 0 1 0 0 10 0 0 1 0 1 7 0 7 1 0 1
1 0 5 13 4 0 1 0 1 0 0 11 0 0 1 0 1 0 3 13 6 0 1
1 15 0 0 1 7 1 0 1 0 0 12 0 0 1 0 1 7 1 0 0 15 1
5 2 4 0 1 0 1 0 5 2 2 2 2 2 6 0 1 0 1 0 3 2 6
1 7 14 0 14 7 14 0 0 0 0 8 0 0 0 0 14 7 14 0 14 7 1
3 2 6 0 5 2 6 0 3 2 4 0 3 2 4 0 5 2 6 0 5 2 4
1 15 0 0 0 0 0 0 1 0 1 0 1 0 1 0 0 0 0 0 0 15 1
1 0 3 13 4 0 3 13 5 2 6 0 5 2 6 13 4 0 3 13 4 0 1
1 0 1 7 1 0 1 16 0 7 14 0 14 7 0 16 1 0 1 7 1 0 1
1 0 1 0 1 0 1 0 3 2 6 0 5 2 4 0 1 0 1 0 1 0 1
1 0 1 7 1 0 1 7 1 0 0 0 0 0 1 7 1 0 1 7 1 0 1
1 0 5 13 6 0 1 0 1 0 3 2 4 0 1 0 1 0 5 13 6 0 1
1 0 0 0 0 0 1 7 1 0 1 7 1 0 1 7 1 0 0 0 0 0 1
1 0 3 13 4 0 5 13 6 0 5 13 6 0 5 13 6 0 3 13 4 0 1
1 0 1 16 1 15 0 0 0 0 0 0 0 0 0 0 0 15 1 16 1 0 1
1 0 5 13 6 0 3 2 2 2 2 0 2 2 2 2 4 0 5 13 6 0 1
1 15 0 0 0 0 14 7 0 7 0 7 0 7 0 7 14 0 0 0 0 15 1
5 2 2 2 2 2 2 2 2 2 2 2 2 2 2 2 2 2 2 2 2 2 6